1111111111111111111
1200010011000000001
1110101110001111101
1000101000100110011
1101000111110101101
1101010101010100011
1100000101000000101
1111011110101101011
1100000100100100011
1101101001010100011
1101100100101110011
1110001101110101011
1110100100110100111
1110010110001010111
1000011101000011011
1101110110101100101
1110000101000101111
1111010111010010111
1111000000110100011
1010001011000001001
1011000000000010101
1010001010010110001
1010010000010000101
1010000000010000111
1000000101000101001
1011100001011000001
1001001101010000101
1001001100000001001
1001000110110110011
1001111100000010101
1100000010011100001
1001000010010000001
1000100001001001001
1011000100000101001
1000101010010101001
1000010000011101111
1011111001000010001
1000000010010000031
1111111111111111111
