1201111111110001010
1101000101000101010
0101101100011101010
0100001101010001010
0111101101000111010
0010001100011101010
1010100001000001010
1000001001010001000
1011111111011111010
1010000100010001010
0010110101010000010
0110000101011011111
0010110101010001000
0110100000010100010
0010110111110101010
1010100001010101010
1010001101010101010
1011011111010101000
1110010001010101010
0010010100000001010
0010000101000101010
0011111111111101011
0000000000001101000
0111111110101100000
0010000011111111110
1010001010000000010
1011111010111011110
1000010000100000000
1000010010000001000
1000010001001000000
1000000001000000111
1010111011110110100
1001000000000000000
0001000001001110000
0000000000000001000
1010111001000100000
0010010011000100000
0011110000100100001
0000000000000011131
